##############################
#S....#...............#.......
###.###########.#.###.###.###.
#.#.#.#.......#.#.#.........#.
#.#.#.#.#####.#########.#.#.#.
#.......#.#.......#...#.#.#.#.
#.#.#.###.#######.#.#.#.###.##
#.#.#...#.#.#.#.....#.....#.#.
#########.#.#.###.#.###.###.#.
#.........#.......#.#...#.....
#.#######.#.#.#############.##
#.#.#...#...#...#...#.........
###.###.#.###.###.#######.#.#.
#.........#...#...#.......#.#.
#######.###.#####.###.###.###.
#.......#...#.#.........#.#...
#.#.#.#.#.#.#.#######.#.#.###.
#.#.#.#.#.#.#.#...#...#.#...#.
#############.#.#.###.#######.
#...............#.......#.....
#.#######.#.###.###.#.###.####
#.#.#.....#.#.....#.#.#.....#.
###.#######.#########.###.#.#.
#.#.......#.....#...#.#...#...
#.#######.#.#######.###.###.#.
#...........#.............#.#.
#.#.#.#.#.###.###############.
#.#.#.#.#.#...#...............
#.#.#####.#.###.###.#.#.#.#.T.
#.#...#...#...#.#...#.#.#.#.#.
