##############################
#S#...#.#...#.#.........#.....
#.#.###.###.#.###.#.#########.
#...#.#.#.#.#...#.#.#...#.#.#.
#.###.#.#.#.###.###.#.###.#.#.
#...#...#.....#.#.#...........
###.#.###.#####.#.#.#####.###.
#.#.......#...#.#...#...#...#.
#.#.#########.#.#.#.#.########
#...#.#.#.#.....#.#.#.#.#.....
###.#.#.#.#.#######.#.#.#.#.##
#...#.#...#...#.......#...#.#.
###.#.#.###.#######.###.#####.
#.#...#.........#.#...#.......
#.#.###.###.#####.#.###.######
#.#.#.#...#...#.#.#.....#...#.
#.#.#.#.#######.#.#.#######.#.
#.....#...#.......#...........
###.#####.#######.#.###.#####.
#.....#.......#.#.....#.....#.
###.#####.#####.#.#####.######
#...#.......#...#...#.#...#.#.
###.#####.###.###.#.#.###.#.#.
#.................#...#.#.#...
#####.###.#.###########.#.#.##
#.......#.#.............#.....
#####.#######.#.###.###.#####.
#...........#.#...#...#...#...
#.#.#.#.#.###.#.###.#.###.#.T.
#.#.#.#.#...#.#...#.#...#.#.#.
